##########
#T.......#
########.#
#C.......#
##########