#........#
#T.......#
..######..
#C.......#
#........#